111111111111111111
11111111E000001111
1P0000000000000C11
111111111111111111