1111111111111111
10000P0000000001
10111110C1011011
111111C111100001
1010100010100011
1E00001000000011
1111111111111111