1111111111111111111
1111111111111111111
1111111111111111111
1P000000C000000C111
1101111111111111111
1101111111111111111
11E1111111111111111
1111111111111111111
1111111111111111111