111111111111111111
1P1C111E0011000111
100000000100010C11
111111111111111111