111111111111111111
1P0C0E001111111111
111111111111111111