1111111111111111111
1P0C0E0011111111111
1000000001111111101
1111111000000001101
1110000011110000111
11111110C0000000001
1100110011001100111
1111111C11110111111
1111111111111111111