111111111111111111
1P0C000E00000000C1
111111111111111111