111111111111111111
111111111111111111
111111111111111111
1P000000C000000C11
110111111111111111
110111111111111111
11E111111111111111
111111111111111111