1111111111111111111
100000000C0000000E1
1011111111111111111
1011111111111111111
1011111111111111111
1011111111111111111
1P11111111111111111
1111111111111111111